###.###.###..#
#...#.....#
...#......#
#...##....#
##.#.#.##....#
##.......##
##...#....#
#..#.@..#..#
#....#....#
..##.##.#.##
#..#..#.#