#..####.##
..##.#.#.##
.##.......#
.##.......#
#.#@...#..#
...####...#
..#..#....#
.##.##.#.##
.#......##
.#..#..##
.#######