###########
#...#.....#
...#......#
#...##....#
##.#.#.##
##.......##
##...#....#
#.#....#..#
#....#@...#
.##.##.#.##
#..#..#.#